1111111111
100CC00111
11000001C1
1000000001
1E00001111
11100000P1
1111111111
