111111
1C0001
1P0001
1000E1
111111
111111
111111
