111111111111111111111111111111111111111
1E0000000C00000C000C00E0000C000C0000PE1
1111111111111111111110E0111111111111111
111111111111111111111000111111111111111
111111111111111111111111111111111111111