111111111111111111111111111111
1E1000011111100000001CCC0001C1
10100011111100C1C0001111100101
101000CC1111110000000000000101
101001100000111110000000000001
10000100000000000000C11C100001
101001101011111100000000000001
100001C010000000001CCC110000P1
111111111111111111111111111111