1111111111111111111111111111111111
1X00000000000000U000000000000000E1
100000000000C000CCCC00000000000001
10000000000C000000C000000000000001
1000000000CCCC000C0000000000000001
1000000000000C00CCCC00000000000001
1000000000000000000000000000000001
1E00000000000000P000000000000000X1
1111111111111111111111111111111111