111111111111111111111111111111
1E000000X00000000000000000C1C1
10000000X0000X000000000000CCC1
10000000X000X0000000000000CCC1
100000000X0000000000X00000CCC1
100000000XX000000000000000CCC1
1X000000X00000000000000000CCC1
100000XX000000000000000000CUP1
111111111111111111111111111111