111111111
10C0000U1
100X00001
100000XE1
100E00111
110000111
10C111111
1000000P1
111111111