111111111
10XC000U1
100000001
100000XE1
100E00111
110000111
10C111111
1000000P1
111111111