111111111111111111111111111111
1E0X0X0X0X0X00000000000000C1C1
10X0X0X0X0X0X0000000000000CCC1
1X0X0X0X0X0X00000000000000CCC1
10X0X0X0X0X0X0000000000000CCC1
1X0X0X0X0X0X00000000000000CCC1
10X0X0X0X0X0X0000000000000CCC1
1X0X0X0X0X0X00000000000000CUP1
111111111111111111111111111111