111111111111111111111111111111111111111111111111111111111111111111111111111
1E1000011111100000001CCC0001C1111111111111111111111111111111111111111111111
10100011111100C1C0001111100101111111111111111111111111111111111111111111111
101000CC1111110000000000000101111111111111111111111111111111111111111111111
101001100000111110000000000001111111111111111111111111111111111111111111111
10000100000000000000C11C100001111111111111111111111111111111111111111111111
101001101011111100000000000001111111111111111111111111111111111111111111111
100001C010000000001CCC11000001111111111111111111111111111111111111111111111
111111111111111111111111111111111111111111111111111111111111111111111111111
1E1000011111100000001CCC0001C1111111111111111111111111111111111111111111111
10100011111100C1C0001111100101111111111111111111111111111111111111111111111
101000CC1111110000000000000101111111111111111111111111111111111111111111111
101001100000111110000000000001111111111111111111111111111111111111111111111
10000100000000000000C11C100001111111111111111111111111111111111111111111111
101001101011111100000000000001111111111111111111111111111111111111111111111
100001C010000000001CCC11000001111111111111111111111111111111111111111111111
111111111111111111111111111111111111111111111111111111111111111111111111111
1E1000011111100000001CCC0001C1111111111111111111111111111111111111111111111
10100011111100C1C0001111100101111111111111111111111111111111111111111111111
101000CC1111110000000000000101111111111111111111111111111111111111111111111
101001100000111110000000000001111111111111111111111111111111111111111111111
10000100000000000000C11C100001111111111111111111111111111111111111111111111
101001101011111100000000000001111111111111111111111111111111111111111111111
100001C010000000001CCC11000001111111111111111111111111111111111111111111111
111111111111111111111111111111111111111111111111111111111111111111111111111
1E1000011111100000001CCC0001C1111111111111111111111111111111111111111111111
10100011111100C1C0001111100101111111111111111111111111111111111111111111111
101000CC1111110000000000000101111111111111111111111111111111111111111111111
101001100000111110000000000001111111111111111111111111111111111111111111111
10000100000000000000C11C100001111111111111111111111111111111111111111111111
101001101011111100000000000001111111111111111111111111111111111111111111111
100001C010000000001CCC11000001111111111111111111111111111111111111111111111
111111111111111111111111111111111111111111111111111111111111111111111111111
1E1000011111100000001CCC0001C1111111111111111111111111111111111111111111111
10100011111100C1C0001111100101111111111111111111111111111111111111111111111
101000CC1111110000000000000101111111111111111111111111111111111111111111111
101001100000111110000000000001111111111111111111111111111111111111111111111
10000100000000000000C11C100001111111111111111111111111111111111111111111111
101001101011111100000000000001111111111111111111111111111111111111111111111
100001C010000000001CCC11000001111111111111111111111111111111111111111111111
111111111111111111111111111111111111111111111111111111111111111111111111111
1E1000011111100000001CCC0001C1111111111111111111111111111111111111111111111
10100011111100C1C0001111100101111111111111111111111111111111111111111111111
101000CC1111110000000000000101111111111111111111111111111111111111111111111
101001100000111110000000000001111111111111111111111111111111111111111111111
10000100000000000000C11C100001111111111111111111111111111111111111111111111
101001101011111100000000000001111111111111111111111111111111111111111111111
100001C010000000001CCC110000P1111111111111111111111111111111111111111111111
111111111111111111111111111111111111111111111111111111111111111111111111111