111111111
100C00001
100000001
1000000E1
100E00111
110000111
10C111111
1000000P1
111111111