111111111111111111111111111111
1E100000X111100000001CCC0001C1
10100011111100C1C0001111100101
101000CC1111110000000000000101
10100110000011111000X000000001
1000010000X000000000C11C100001
101001101011111100000000000001
100001C010000000001CCC11000UP1
111111111111111111111111111111