111111111111111111111111111111111111111
1E0000000C00000C000C0000000C000C00000E1
10001001000001000100CCCCC10001000000001
100100001001000000000100000001011100001
100100000000000000000100000001011100001
111111101111110000000000000011111111011
111111101111111111111110111111111111011
110000000000000001111000110001100000001
1000001001000001000100000001000100000P1
111111111111111111111111111111111111111